---P--P---
--W-------
------P---
-----P----
---G------
W-----P---
----------
P------W--
---W--P---
----------